====================
#                  #
#  YYY   YYY   YYY #
#                  #
#  +     +     +   #
@@ @@      @@@@@@@@@
#                  #
#  +    +     +    #
#                  #
~~LL~~~L~~LL~~~L~~L~
#                  #
#  YYY   YYY   YYY #
@@ @@@@@@@@   @@@@@@
#                  #
#  +   +     +   + #
#                  #
~~LL~~LL~~~~LL~~LL~~
~~LL~~LL~~~~LL~~LL~~
#                  #
#  YYY   YYY   YYY #
@@ @@@    @@@@@@@@@@
#                  #
#   +   +   +   +  #
#                  #
~~LL~~~LL~~LL~~~LL~~
~~LL~~~LL~~LL~~~LL~~
#                  #
    #  YYY   YYY   YYY #
#                  #
#     C            #
####################